NO ./textures/north_texture.xpm
SO ./textures/south_texture.xpm
WE ./textures/west_texture.xpm
EA ./textures/east_texture.xpm

F 163, 126, 190
C 127, 173, 177

        1111111111111111111111111
        1000000000110000000000001
        1011000001110000000000001
        1001000000000000000000001
111111111011000001110000000000001
100000000011000001110111111111111
11110111111111011100000010001
11110111111111011101010010001
11000000110101011100000010101
10000000000000001100000010101
10000000000000001101010010001
11000001110101011111011100N0111
11110111 1110101 101111010101
11111111 1111111 11111111111