NO ./textures/north_texture.xpm

SO   ./textures/south_texture.xpm
WE                                    ./textures/west_texture.xpm

C  127    ,     173, 177
EA                      ./textures/east_texture.xpm


   F 1, 2, 1

11111                               
    11111111111111111111111111
1111110000100000000000001111111   
1000110000111100111111E0111      
10001100001   1000001100011    
100000000011110000000100111   
11111111111111111111111111
1 1
1 1
1111111111                 