WE ./textures/east_texture.xpm
NO               ./textures/north_texture.xpm


F 220,               100,0


EA  ./textures/west_texture.xpm 
SO       ./textures/south_texture.xpm 

C 225,30,0

1111
1101
10N1
1111

 