NO ./textures/north_texture.xpm
SO ./textures/south_texture.xpm
WE ./textures/west_texture.xpm


F 20,20,20
C 200,200,200

 1
1111
10001
10001
10001
10001
10001
11001
10001
10001
10001
10001
100E1
11111
1 1