NO ./textures/north_texture.xpm
SO ./textures/south_texture.xpm
WE ./textures/west_texture.xpm

F 20,200,100
EA ./textures/east_texture.xpm 
C 200,200,200


         11
        11 
        1   
 111111111111111
10000000001100001
10100000110000001
 1001001100N0001
  1011000000001
   11111111111