NO ./textures/north_texture.xpm
SO ./textures/south_texture.xpm
WE ./textures/west_texture.xpm
EA ./textures/east_texture.xpm

F 163, 126, 190
C 127, 173, 177


1111111111111111111111
10N0000000000000000001
1001111000111000000001
1001000000100100000001
1001000000100100101001
1001111000111000010001
1001000000100100101001
1001000000100100000001
1001000000111000000001
1000000000000000000001
1000000000000000000001
11111111111111111111111