NO ./textures/north_texture.xpm
SO ./textures/south_texture.xpm
WE ./textures/west_texture.xpm
EA ./textures/east_texture.xpm

F 20,20,20
C 200,200,200


11111
1N001
10001
10001
10001
10001
11001
10001
10001
10001
10001
10001
11111
11


